CCCCCCCCCCCCCCCCCCCCCCCCCCCCCCCCCCCCCCCCCCCCCCCCCCCCCCCCCCCCCCCCCCCCCCCCCCCCCCC CCCC  CCCC       CCCCCC CCCCC     CCCCCCW
W                                                                             w w  w  w  w       w ww w w               W
W                                                                             w w  w  w  ========= ww w w               W
W                                                     D 4    D                w w  ====            == w w               W
W                                                   =============             w w                     ===               W
W                                                   D           D   DDD       ===        D   1   D                      W
W                                 D         D       DD      [] DD   D D   D             DD=======DDD                    W
W e     DDD          []           DD        D  D    DD   5  {} DDDDDD D   DD           DDD []    DDDD    []           x W
W E     DDD     D   1{} D         DDD 5  D  D  D   FFFFFFFFFFFFFFFFFFFF   FFFFFFD  6  DDDD {}    DDDDD   {}        BJhs W
WFFFF   DDD  FFFFFFFFFFFFFF       FFFFFFFF  D  DFFF                    FFF      FFFFFFFFFFFFFFFFFFFFFFFFFFFFF     FFFFFFW
     ________              _______        _____                                                              _____       
////////////////////\\\\\\\\\\\\\\\\\\\\////////////////////\\\\\\\\\\\\\\\\\\\\////////////////////\\\\\\\\\\\\\\\\\\\\